8
00111111
10000001
11101111
11101111
10000001
10111111
10000000
11111110